#############################################################
#..#...........#..#.....#.....#..#..#.................#.....#
#..#..#..#######..#..#..#..#..#..#..####..####..####..#..####
#.....#.....#........#..#..#.....#.....#..#..#..#...........#
#..#..####..####..#############..#..#######..#..####..#######
#..#..#..............#..#..#....................#..#..#..#..#
#..#..#..####..####..#..#..#..#..#######..#######..####..#..#
#..#..#.....#..#.....#..#..#..#..#..#.....#........#........#
#..###################..#..#..####..####..#..#######..#######
#....................#........#..#..............#...........#
#..#..#..#######..#..#..####..#..#######..################..#
#..#..#..#.....#..#..#..#..#..#..#........#.....#.....#.....#
#..##########..#..#######..####..#..#######..#..#..####..#..#
#........#..#..#........#.....#.....#..#.....#........#..#..#
#..#######..#..#######..#..####..####..#..####..#..#..#..#..#
#..............#.....#..............#..#..#.....#..#.....#..#
#..#..#..#..####..#######..#..####..#..#######..#############
#..#..#..#..#...........#..#.....#........#.................#
#..#..####..####..#############..#..####..#..####..#..#..####
#..#..#..#..............#........#..#..#..#..#.....#..#.....#
#######..#..###################..####..####..#..#..####..#..#
#.....#.....#..#..#..#...........#..#.....#..#..#..#.....#..#
#..##########..#..#..#..#..#######..#..####..#######..#######
#...........#...........#.....#..............#........#.....#
####..#..####..##########..#..#############..#..####..#..####
#.....#.....#..#.....#.....#........#.....#..#.....#........#
#######..####..#..#######..#############..#..#..#..#######..#
#..#.....#.....#...........#..#..#.....#..#..#..#..#........#
#..####..#..#..#..##########..#..#..#..#..####..#..#..#######
#..#.....#..#..#..#.....#..#.....#..#.....#..#..#..#........#
#..#..#######..####..####..####..#..#######..#..####..####..#
#.....#...........#........#.....#..#...........#........#..#
#..#############..#..#######..####..####..##########..####..#
#................................#.....#..#........#.....#..#
#..##########..#..####..#..#..####..#..#..####..#..##########
#.....#.....#..#..#..#..#..#.....#..#...........#...........#
####..####..#..####..#######..####..####..#..#######..#..#..#
#...........#.....#....................#..#.....#..#..#..#..#
#..####..#######..#######..####..#..####..#######..#######..#
#.....#..#..............#..#.....#..#..............#........#
#############################################################