#############################################################
#...........#..#..#...........#........#....................#
#..##########..#..#..#######..#######..####..#..##########..#
#..............#........#..#..#........#..#..#........#.....#
#######..#..#######..####..####..#..#..#..#..#..#..#######..#
#........#.................#..#..#..#..#.....#..#..#........#
####..################..#..#..#..#############..##########..#
#..#.....#...........#..#..#.....#..#........#..#...........#
#..#######..####..#######..####..#..#######..#############..#
#..#.....#..#...........#........#.....#.....#.....#........#
#..#..####..#######..##########..####..####..#..##########..#
#.....#.....#.....#...........#..#........#..............#..#
####..####..#..##########..####..#..#..#######..#..####..#..#
#..#.....#..#..#..#..#..#...........#........#..#..#........#
#..#..#..#..#..#..#..#..##########..#..#############..#..#..#
#.....#..............#..#...........#.....#..#.....#..#..#..#
#..#..################..#############..#..#..#..#######..####
#..#.....#.................#..#........#.....#.....#..#.....#
#..#######..####..#..#..####..#..#############..####..####..#
#.....#.....#.....#..#..#..#..#....................#........#
#######..#..##########..#..#..#..##########..####..####..#..#
#..#..#..#..#.....#..#.....#........#...........#.....#..#..#
#..#..#..####..#..#..#..#############..#############..####..#
#........#.....#..............#........#..............#.....#
#..#######..##########..#######..#######..#######..#..#..#..#
#........#..#..#..#.....#..#.....#.....#........#..#.....#..#
####..####..#..#..#..####..####..####..##########..#..####..#
#..#.....#..#...........#..#.....#.................#..#.....#
#..#..##########..####..#..####..#..######################..#
#........#...........#...........#........#........#.....#..#
#############..#..####..#..#..####..#..#..#..#..#######..#..#
#..#.....#.....#.....#..#..#..#.....#..#..#..#..#........#..#
#..####..#..#######..#############..####..#..#######..####..#
#.................#..............#..#..#.....#.....#.....#..#
######################..#############..#..####..#######..#..#
#...........#.....#..............#..#..#........#..#........#
#######..#######..#..##########..#..#..####..####..#######..#
#.....#..#..#.....#..#..#..#........#..#........#.....#..#..#
#..####..#..#..####..#..#..#..#..####..#..#..####..####..#..#
#..........................#..#........#..#........#........#
#############################################################