#############################################################
#........#........#.................#.....#...........#.....#
#######..#######..####..#######..####..#..#..####..#######..#
#...........#..#........#..#..#.....#..#..#..#..............#
#######..#..#..#..#######..#..#######..#..#..#######..#..#..#
#........#........#...........#.....#..#...........#..#..#..#
#..#..####..#######..####..#..#..####..#############..#######
#..#.....#........#..#..#..#.....#..............#...........#
#..####..#..#..####..#..#..####..#..#############..##########
#..#.....#..#........#..#.....#.................#........#..#
#############..####..#..#..#######..#..####..####..#######..#
#........#.....#..#..#..#........#..#..#........#........#..#
#..#######..#..#..####..#######..#############..####..#..#..#
#..#.....#..#........#.......................#..#..#..#.....#
#..####..#############..################..#######..####..####
#...........#..#..#........#........#.....#..#..............#
##########..#..#..#..##########..#..#..#..#..#######..#..#..#
#...........#.....#..#..#..#..#..#..#..#.....#........#..#..#
#..#..####..#..####..#..#..#..#..#..################..#..#..#
#..#..#.................#..#..#..#.....#..#........#..#..#..#
#..#..#######..#..#..####..#..####..####..#######..####..#..#
#..#..#........#..#..#.....#...........#..#.....#........#..#
#..#######..#######..#..##########..#..#..####..#..#..#..####
#..#.....#.....#..#..#..#..#..#.....#..#...........#..#..#..#
#..####..####..#..#..#..#..#..#..#######..####..##########..#
#.....#.....#..#.....#..............#........#..............#
#..####..#..#..####..####..####..##########..#..####..#######
#.....#..#.....#.....#.....#..#..............#..#.....#.....#
#..####..#..#..#..##########..#..####..#..#######..#..####..#
#.....#..#..#..#.....#..............#..#.....#.....#..#..#..#
##########..##########..#######..#######..####..####..#..#..#
#........#..#.....#.....#.....#..#.....#.....#..#..#..#.....#
#..####..#..####..#..#..#..####..####..#..#..####..#..#..#..#
#.....#........#.....#.....#..#..#..#..#..#..#...........#..#
##########..##########..#..#..#..#..#..#..####..#######..#..#
#..#..#..............#..#.....#..#...........#........#..#..#
#..#..####..#######..################..#..#######..##########
#.....#..#..#..#.....#..#........#.....#..#..#..#.....#.....#
#..#..#..#..#..#..####..#..#..####..#..####..#..####..#..#..#
#..#...........#...........#.....#..#...........#........#..#
#############################################################