#############################################################
#........#..#...........#..#..#...........#........#..#.....#
#..#######..#..#..####..#..#..#..#..#############..#..####..#
#..#..#.....#..#.....#........#..#....................#..#..#
#..#..#..#######..#######..##########..##########..####..#..#
#........#........#..#........#..#.....#...........#........#
#######..####..####..#..#..#..#..####..#######..####..#..####
#..#.................#..#..#...........#..#.....#.....#..#..#
#..#..####..#..#############..####..####..####..####..####..#
#..#.....#..#...........#..#.....#..#........#..#........#..#
#..#..####..####..#######..#..##########..####..#..#######..#
#........#..#..............#..#.............................#
#..####..#..##########..####..####..####..####..#..##########
#.....#..#..#.....#.....#.....#........#..#..#..#.....#.....#
#..####..####..#######..###################..#..##########..#
#..#..#...........#.....#..#..#.............................#
####..#..####..#..#######..#..####..#######..#######..#..#..#
#.....#..#..#..#.....#...........#.....#...........#..#..#..#
#..#..#..#..#..#######..#..#..#..####..#..####..##########..#
#..#..#..#.....#.....#..#..#..#........#..#........#........#
#..####..####..####..#..#..#..#..#######..####..#..#######..#
#........#.....#..#..#..#..#..#.....#........#..#..#.....#..#
####..##########..#..#..####..#..#..#..####..#######..#..#..#
#..#..#.....#...........#..#..#..#..#.....#........#..#.....#
#..#..####..####..####..#..#..####..#..#..###################
#.....#.....#..#.....#..#..#.....#..#..#..#..............#..#
#..#######..#..#######..#..#######..#..#..#..##########..#..#
#........#..#.....#...........#.....#..#..#.....#.....#.....#
#######..#..#..#######..#..#############..#..#..####..####..#
#..#.................#..#.....#..#........#..#........#.....#
#..#..####..#######..####..#..#..#######..##########..#######
#..#..#.....#........#.....#..#........#.....#.....#..#.....#
#..####..#..##########..####..#######..#..####..#..#..####..#
#........#.....#..#.....#..#.....#..#...........#..#.....#..#
##########..####..####..#..#######..##########..####..####..#
#.....#.....#.....#..#.....#..............#........#........#
####..#..#..#..####..#..#..##########..#..#..####..####..####
#........#.....#..#.....#..............#..#..#..............#
####..#..####..#..#######..#..#..####..#############..#..#..#
#.....#..#........#........#..#.....#.....#...........#..#..#
#############################################################