#############################################################
#...........#...........#........#..#.....#..#........#.....#
#######..####..####..####..#..#..#..#..#..#..#######..#..#..#
#..............#..#........#..#.....#..#........#.....#..#..#
################..##########..#######..####..####..#..#..####
#...........#.....#.....#...........#..#...........#..#.....#
#..#######..#..####..####..#..#############..##########..#..#
#.....#..#...........#.....#...........#..#..............#..#
#..#..#..#..#..##########..#..####..####..#..####..#..#..#..#
#..#.....#..#..#..#........#..#..#..#........#.....#..#..#..#
#..####..#..#..#..#..##########..####..####..####..#######..#
#..#.....#..#..#.................#.....#.....#.....#.....#..#
#############..################..####..####..####..#..####..#
#........#..#...........#..............#.....#.....#..#.....#
#..#######..####..####..####..#######..##########..#..#..#..#
#..#..#...........#..#.....#........#.....#..#..#.....#..#..#
#..#..#######..####..#..#..#######..#######..#..##########..#
#..#........#..#..#.....#...........#...........#...........#
#..#..####..#..#..#######..#..#..#############..##########..#
#..#..#...........#........#..#.....#..#..#........#........#
#..#..#..#..##########..#..####..####..#..#..#######..#######
#..#..#..#........#.....#.....#.....#..#.....#...........#..#
#..#..####..######################..#..####..####..####..#..#
#.....#...........#..#..#..#..#.....#.....#..#........#.....#
#..#..#######..#..#..#..#..#..#######..#..#..####..####..####
#..#..#.....#..#.....#.................#...........#........#
#..#######..#..#..##########..#######..#..####..#######..#..#
#...........#..#..#........#..#.....#..#..#........#..#..#..#
####..#..##########..#..#..#..#..#######..#######..#..#..####
#.....#..#...........#..#..#........#........#..#..#.....#..#
#..#..#..#######..####..###################..#..#######..#..#
#..#..#..#..#.....#.....#..............#..#.....#...........#
#..####..#..####..#######..#..####..####..#..#..####..####..#
#.....#.....#........#..#..#..#..............#.....#..#.....#
#######..####..#######..####..#######..################..#..#
#..#........#........#........#........#..#...........#..#..#
#..#..#..#######..#..#..#######..#..#..#..#..####..##########
#.....#..#........#.....#..#.....#..#.....#..#........#.....#
#######..#..#..####..#..#..####..#..####..#..#..####..#..####
#........#..#..#.....#.....#.....#..#........#.....#........#
#############################################################