#############################################################
#..#..#..#.....#..#..............#........#.....#...........#
#..#..#..#..#..#..####..#..##########..#..#..#..####..####..#
#.....#..#..#..#..#..#..#..#.....#..#..#..#..#........#.....#
#..####..#..#..#..#..####..####..#..#..#..#..#######..####..#
#...........#.....#..#.....#........#..#........#..#..#.....#
#..####..#######..#..#..####..#######..####..####..#..####..#
#..#..#.....#........#...........#..#.....#........#..#..#..#
#..#..####..#..#..####..#######..#..####..####..#..####..#..#
#..#..#.....#..#..............#........#..#.....#..#.....#..#
#..#..#..################..####..#..#..#..#..##########..#..#
#..#........#..#.....#..#.....#..#..#.....#..#..#..#.....#..#
####..####..#..#..####..#..####..#######..####..#..#..####..#
#.....#........#........#.....#..#.....#.....#..............#
####..#..#..##########..#..#..####..#..#..#######..#######..#
#.....#..#..#...........#..#.....#..#........#........#..#..#
#..#..#..#..####..####..#########################..#..#..####
#..#..#..#..#.....#..#..#..#........#..............#........#
#..####..#..#..####..#..#..####..################..#######..#
#..#.....#..#..#........#..#..#........#...........#..#.....#
####..#..#######..#######..#..#######..#..#..####..#..####..#
#.....#.....#....................#........#..#........#.....#
####..#..#..####..###################..#..#######..#..#..####
#..#..#..#..#..#.....#.....#..#.....#..#..#.....#..#..#..#..#
#..####..####..####..#..####..#..####..####..#..#..####..#..#
#...........#..#..#...........#..#.....#.....#..#.....#.....#
#..####..#..#..#..#######..####..#..##########..#######..####
#..#.....#..#..#...........#.......................#........#
#..#..####..#..#..####..####..################..##########..#
#..#..#.....#........#..#..#........#.....#..#.....#.....#..#
##########..#..#..####..#..#..#..####..####..#..#######..#..#
#........#.....#..#........#..#..#........#........#..#.....#
#..################..#######..####..#######..#######..####..#
#..#.....#..............#.....#..#.....#..#.....#...........#
#..#..####..################..#..####..#..#..##########..####
#..#..#..#.....#.....#.....#..#.................#...........#
#..#..#..#..####..#..####..#######..####..####..##########..#
#........#..#.....#..#..#...........#..#..#..#..#........#..#
#######..#..#..#..####..##########..#..####..#..####..####..#
#..............#...........#..............#.....#...........#
#############################################################