#############################################################
#.................#.................#..#..#..#..#..#.....#..#
#..#..#..#..#..####..#..#..#######..#..#..#..#..#..####..#..#
#..#..#..#..#..#.....#..#..#...........#.....#.....#..#.....#
####..####..##########..#..##########..####..#..####..####..#
#..#..#...........#.....#...........#.....#.................#
#..#..#..#######..#..####..######################..#..####..#
#.....#.....#..#........#..#........#..#.....#.....#.....#..#
#..#..####..#..####..####..#..####..#..#..#..#..##########..#
#..#..#........#..#.....#..#..#........#..#..#........#..#..#
#############..#..#######..#######..#..#..#######..####..#..#
#........#.....#.....#..............#..............#.....#..#
#######..#######..####..#..####..#..################..####..#
#..#..#.....#...........#..#..#..#..#........#..#...........#
#..#..####..#..#..#..#..####..#..#######..#..#..#############
#..#........#..#..#..#..#..#........#.....#..#........#.....#
#..#..####..#######..#..#..#..#######..####..#..####..####..#
#........#.....#.....#..#........#.....#.....#.....#..#.....#
####..#############..####..#..####..#..#..#######..#######..#
#...........#.....#..#.....#..#.....#..#..#..#..............#
#..#######..####..####..####..#..#######..#..#..#..#..#######
#..#..#........#........#..#...........#..#.....#..#........#
#..#..####..####..#######..#######..#############..####..####
#.....#..#..#..#.....#..#...........#.....#........#.....#..#
#..#..#..#..#..#..####..####..#######..####..##########..#..#
#..#..#..#........#.....#..#........#..............#..#..#..#
#..####..#############..#..####..##########..#######..#..#..#
#.................#..#........#........#........#...........#
#..#..#..####..####..#..#..#######..#######..#..####..####..#
#..#..#..#........#.....#........#.....#.....#..#.....#.....#
#######..#..####..##########..####..#######..####..####..#..#
#.....#..#.....#..#...........#.....#..#........#..#..#..#..#
####..#..#..####..#..####..####..#..#..#############..#..####
#........#..#........#........#..#.....#...........#..#.....#
#..#############..####..#..####..#######..####..####..####..#
#..............#.....#..#..#..#...........#.....#..#........#
####..#######..####..#..#..#..####..#..#######..#..#..####..#
#..#..#..#.....#.....#..#........#..#.....#........#..#..#..#
#..#..#..#..#..##########..#..####..####..#..####..#..#..#..#
#.....#.....#.....#........#.....#.....#..#.....#........#..#
#############################################################