#############################################################
#..#........#....................#........#.....#.....#.....#
#..####..#..#..#..####..#..#..#..#..#..####..####..#..####..#
#..#.....#..#..#..#.....#..#..#..#..#.....#........#..#..#..#
#..####..#######..####..#..#######..####..#..#######..#..#..#
#..............#..#..#..#.....#..#..#........#..#...........#
####..#..#######..#..####..#..#..#..####..####..#######..####
#..#..#.....#..#..#.....#..#........#.....#.....#..#..#..#..#
#..#..####..#..####..#..####..#..#######..####..#..#..####..#
#..#..#..#.....#.....#.....#..#........#..#.....#...........#
#..####..#..#..#######..#..####..#..####..####..#..##########
#..#.....#..#.....#.....#..#.....#..#.................#..#..#
#..#..#..####..####..#..#############..####..#..#..#..#..#..#
#.....#..#........#..#.....#..#........#..#..#..#..#........#
#..#######..#..#..#######..#..#######..#..####..####..#######
#...........#..#.....#.....#.....#........#.....#...........#
#..#######..####..####..#..#..####..#######..#######..#..####
#.....#.....#...........#........#..#........#.....#..#..#..#
#######..###################..####..#######..#..####..#..#..#
#..#...........#.....#........#...........#..#.....#..#.....#
#..#..####..####..####..####..#..#..####..#..#..#..#..#..####
#..#..#.....#..#........#.....#..#..#.....#..#..#.....#.....#
#..#######..#..####..#..################..##########..#######
#........#..#..#.....#..#..#..#..#.....#........#...........#
#..#..####..#..#######..#..#..#..####..#######..##########..#
#..#.....#.....#..#.....#..#..#..#..............#..#.....#..#
#..#######..####..#..#..#..#..#..#..#..#..#..#..#..#..#..####
#..#.....#.....#..#..#...........#..#..#..#..#........#..#..#
#..#..#..#..####..#######..####..################..#######..#
#.....#.....#..#........#.....#.................#..#..#.....#
####..#..#..#..#..##########..#######..#######..#..#..#..####
#.....#..#.....#..............#.....#.....#..#.....#..#..#..#
#######..#######..#######..#######..#######..#..####..#..#..#
#..#........#...........#..#..#..#........#...........#.....#
#..#..#..#..#..##########..#..#..####..#..#######..####..####
#.....#..#..#..#..#....................#..#.................#
#..#############..####..#######..##########..####..#..#######
#..#...........#..#...........#........#..#.....#..#..#.....#
#..##########..#..#######..####..#..#..#..#..####..#..####..#
#.....#....................#.....#..#..#........#..#........#
#############################################################
