#############################################################
#.....#........#...........#.....#.....#...........#..#..#..#
#..####..#..####..#..#..#..#..####..#######..####..#..#..#..#
#.....#..#..#..#..#..#..#..#..#..#...........#..#..#........#
####..####..#..##########..#..#..####..#######..####..#..#..#
#..........................#..............#........#..#..#..#
#..#######..#..#######..####..##########..#..#############..#
#..#.....#..#.....#.....#...........#.....#..#.....#........#
#..#..################..####..#######..####..#..####..#######
#..#...........#........#........#...........#.....#..#.....#
####..####..##########..#######..#######..#..#..#..#..#..#..#
#........#..#...........#..#.....#..#.....#.....#.....#..#..#
#######..####..#######..#..#######..#..####..#######..####..#
#..#........#..#..#..#..#..#..............#........#..#.....#
#..#..####..####..#..#..#..####..#######..####..#..####..####
#..#.....#........#..#.....#..#..#...........#..#..#........#
#..#######..#..#..#..#..####..#############..####..####..####
#..#........#..#.....#....................#.....#...........#
#..####..##########..##########..################..#######..#
#.....#..#..#..#...........#.....#..#...........#..#........#
#..#..#..#..#..#..#######..#..#..#..####..#..#..####..#..####
#..#..#..#...........#........#..#.....#..#..#..#.....#.....#
####..#..#..###################..####..#######..####..#######
#........#..#...........#..........................#........#
#..#..####..####..#######..#######..#..##########..####..####
#..#..#.....#.....#.....#........#..#..#.....#.....#..#.....#
#######..#######..#..#..#..#..####..#######..#######..#..####
#..#..............#..#..#..#.....#..#.....#........#.....#..#
#..#..#..####..#######..################..#..#..#######..#..#
#.....#..#..#..#..............#..#..#..#.....#..............#
#..#######..#..#..#############..#..#..#..#..#..#######..#..#
#...........#.............................#..#..#........#..#
#..####..#..#..#..####..#######..####..#..#######..####..#..#
#.....#..#..#..#..#........#..#..#..#..#..#.....#..#.....#..#
#..####..##########..####..#..####..#..#######..#######..#..#
#.....#...........#..#..#..#..#...........#..............#..#
#..##########..#######..#..#..#############..#..#..#..#######
#.....#..#..#........#.................#..#..#..#..#........#
#..####..#..####..#######..####..####..#..##########..#..####
#........#........#........#........#..............#..#.....#
#############################################################