#############################################################
#.....#.....#...........#.................#...........#.....#
#..#..####..#..#..#######..#..#..####..#..#######..#..#..#..#
#..#.....#.....#.....#..#..#..#.....#..#...........#..#..#..#
#..#..####..####..####..#######..####..#######..#######..#..#
#..#.....#..#...........#.....#..#.....#..............#..#..#
####..#..#######..#..#######..#..#..################..####..#
#.....#..#..#..#..#..#...........#........#.....#.....#..#..#
####..####..#..#..#######..####..#..#..####..##########..#..#
#.....#........#..#..#.....#.....#..#..#........#...........#
#..#..#..#..#..#..#..#..#..################..#..####..#..#..#
#..#.....#..#..#.....#..#.....#.....#..#.....#..#.....#..#..#
####..#..####..####..#..#..#..####..#..#######..#######..####
#..#..#..#.....#........#..#..#..#..#........#..#.....#.....#
#..####..#..####..#######..#..#..#..####..####..#..#######..#
#........#..#.....#........#.....#........#........#........#
#..####..#..#..#######..#############..####..#..#..####..#..#
#.....#..#..#..#...........#..............#..#..#..#..#..#..#
#..####..#######..#######..#######..#######..#..#..#..####..#
#..#........#..#..#.....#..............#..#..#..#...........#
####..#######..#..#..####..#..####..####..#..#######..#..####
#....................#.....#.....#..#..............#..#..#..#
####..#..#..####..##########..####..##########..#######..#..#
#..#..#..#..#...........#........#..#..............#........#
#..#..#..#..####..####..#..################..##########..####
#..#..#..#.....#..#.....#.....#........#........#..#........#
#..####..#..######################..#######..####..#..#..####
#.....#..#..#.....#...........#.....#..#...........#..#..#..#
####..#..#..#..#######..##########..#..#..####..##########..#
#..#.....#..#..#..#.....#..#........#.....#........#........#
#..#..#######..#..#..#..#..#..####..#..####..##########..#..#
#.....#.....#..#..#..#........#.....#..#........#..#.....#..#
####..####..#..#..####..##########..#..####..#..#..#######..#
#.....#.....#..#..#........#..#.....#.....#..#..............#
####..####..#..#..####..#..#..#..#..#..##########..####..####
#.....#.....#........#..#.....#..#.....#..#........#........#
#..#######..#######..#######..#######..#..##########..#..#..#
#....................#.....#.....#..#...........#..#..#..#..#
#..#..#..##########..####..####..#..####..#..#..#..#..####..#
#..#..#...........#....................#..#..#..#........#..#
#############################################################