#############################################################
#.....#..#..............#.....#........#........#..#..#..#..#
#..####..#..#..#######..#..#..#..#..#..#######..#..#..#..#..#
#........#..#........#..#..#..#..#..#..#.....#..............#
#..###################..####..#######..####..#######..#..####
#...........#........#........#.................#..#..#.....#
##########..####..####..####..####..#######..####..#..#..####
#..#...........#...........#.....#..#.................#..#..#
#..#..####..#..####..#######..#..####..####..#############..#
#.....#.....#..............#..#.....#.....#..#..............#
#..#######..#######..#..#######..#..#..#..####..####..#..#..#
#.....#..#..#........#.....#.....#.....#........#.....#..#..#
#######..#..####..####..#..##########..####..####..#..####..#
#..#..#.....#..#..#.....#........#..#..#.....#..#..#.....#..#
#..#..#..#..#..#..#..#..####..#..#..##########..#..####..#..#
#........#.....#..#..#..#.....#.....#..#..#...........#..#..#
#..#######..####..################..#..#..###################
#.....#..#..#..#.....#.....#.....#..#..#...........#..#..#..#
#######..####..#..####..#######..#..#..#######..####..#..#..#
#.....#...........#..#..............#..#.....#..............#
#..################..#..##########..#..#..#..#..####..#..#..#
#.....#.....#.....#..#..#..............#..#.....#.....#..#..#
#..####..#######..#..################..#..#######..#######..#
#........#..#.....#.....#.....#..#..............#..#..#.....#
####..####..####..#..#######..#..#..#..#..#..#######..####..#
#..#..#..............#..#........#..#..#..#.....#...........#
#..#..####..####..#..#..#######..#..###################..####
#..............#..#..#..#.....#..#........#........#..#.....#
#######..#..#..#..####..####..#..#..####..#..#######..#######
#..#.....#..#..#..#........#.....#.....#........#...........#
#..#######..####..#..#######..####..#############..####..####
#...........#..#........#..#...........#..#.....#.....#.....#
#..####..#..#..####..#..#..####..####..#..####..####..#######
#.....#..#..#........#.....#........#..#..#.....#.....#..#..#
#..#..################..####..####..####..#..####..#..#..#..#
#..#...........#.....#..#..#.....#..#..#...........#........#
#############..#..#######..#..#..####..#..####..####..####..#
#.....#........#.....#........#..#...........#..#..#..#..#..#
####..#..####..#..#..#..#######..#..#..#..####..#..####..#..#
#...........#.....#........#........#..#..#.....#...........#
#############################################################