#############################################################
#..#.....#..#.................#.................#.....#..#..#
#..#..#..#..#..#..#..####..#..#######..#..##########..#..#..#
#.....#.....#..#..#..#..#..#.....#.....#.....#..#........#..#
#..#..#############..#..#######..####..####..#..####..####..#
#..#.....#.....#.....#.....#.....#........#..#...........#..#
#..##########..####..####..####..#######..#######..#######..#
#...........#.....#........#.....#........#..#..............#
#######..####..#############..#..#..####..#..#..####..#..####
#..............#..#..#..#..#..#..#..#........#.....#..#..#..#
####..#..####..#..#..#..#..#..####..####..####..#######..#..#
#.....#..#........#..#........#.....#........#.....#........#
#..#..#############..#..##########..##########..#..#..####..#
#..#..#...........#...........#.................#..#..#.....#
#..####..##########..#..##########..#..#############..####..#
#....................#...........#..#..#..............#.....#
#######..#..#######..####..#..####..#..####..#..####..#..#..#
#.....#..#.....#..#..#..#..#........#..#..#..#.....#..#..#..#
#..#..####..####..####..################..#..#######..#..#..#
#..#................................#........#..#.....#..#..#
####..##########..#..##########..#..##########..#..#..####..#
#..............#..#........#..#..#.....#...........#..#.....#
#############..#..##########..#######..####..#######..#..####
#..............#..#..#..#..#.....#..#.....#..#..#.....#..#..#
#..#..#..##########..#..#..#..#..#..#..#######..#######..#..#
#..#..#..#........#.....#.....#.....#..............#.....#..#
#..#######..#######..####..####..####..#######..##########..#
#..#.....#..#........#..#..#..#.....#..#....................#
#..#..#..#..#..####..#..#..#..#######..#######..#..##########
#.....#...........#.....#.....#........#........#........#..#
#..#..##########..##########..#..#..#..####..#..#..#######..#
#..#..#.................#.....#..#..#..#..#..#..#...........#
#..####..################..####..#..####..##########..####..#
#.....#.....#.....#.....#.....#..#........#..#..#.....#.....#
#######..####..#######..#..####..#..#######..#..##########..#
#.....#........#..#........#.....#.....#.................#..#
#..#..#..#..#..#..#..#..####..#..#..####..##########..####..#
#..#..#..#..#.....#..#..#..#..#..#.....#........#........#..#
#..####..#..##########..#..#######..####..#..####..#..####..#
#........#.................#..............#.....#..#.....#..#
#############################################################