#############################################################
#..#.....#...........#..#........#.................#........#
#..#..####..#..####..#..#..###################..#..#..#..####
#..#..#.....#.....#..#..............#.....#..#..#.....#.....#
#..#..#..#..####..#######..#..####..#..#..#..#..####..####..#
#........#..#........#.....#.....#.....#..#..#.....#..#.....#
#..####..#######..#######..#..#######..####..####..#..####..#
#.....#..#.....#...........#..#..#...........#.....#..#.....#
#..#######..#..#..#######..#..#..####..#######..##########..#
#.....#.....#..#.....#..#..#........#...........#...........#
##########..####..#..#..#..#..#############..#..#######..####
#.....#........#..#..#.....#..#........#..#..#..#.....#..#..#
#..#######..#..#..#############..#..#..#..#..#..####..####..#
#...........#........#...........#..#..#.....#..#........#..#
#..#..#######..####..#############..####..####..#..#..#..#..#
#..#.....#.....#.....#..#........#..#..#..#........#..#.....#
#..################..#..#######..#..#..##########..#######..#
#..#...........#........#........#..#.....#..#..#........#..#
#..##########..#..####..#######..#..####..#..#..#######..#..#
#..#..#..#.....#.....#..#....................#........#..#..#
#..#..#..####..#..##########..#..####..#..####..#..#..#..####
#..#..#........#..#.....#..#..#.....#..#..#..#..#..#..#..#..#
####..#..#######..#..####..##########..####..#..#..#######..#
#..#.................#..#.....#.....#.....#..#..#..#..#.....#
#..####..##########..#..####..#..#######..#..#..####..####..#
#.....#.....#........#........#..#..#.....#........#........#
####..#..#..#######..#..####..#..#..####..#######..####..#..#
#.....#..#.....#...........#.....#..#..#..#........#..#..#..#
####..####..#######..####..#..####..#..#..####..####..####..#
#..#..#.....#.....#..#..#..#....................#.....#.....#
#..#..##########..#..#..#..##########..#..#..####..#..#..####
#........#..#..#........#.....#........#..#........#........#
#..#..####..#..#..#..####..################..#..#############
#..#...........#..#.....#.....#.....#..#..#..#.....#........#
#..#..#..################..#######..#..#..#######..#..####..#
#..#..#..#........#.....#..#.....#.....#.....#..#........#..#
#######..####..#..####..#..####..####..####..#..#..#######..#
#..#...........#........#..#........#..#..#...........#.....#
#..#..####..####..#######..#..####..#..#..#..#..####..#######
#........#.....#...........#..#..............#..#...........#
#############################################################