#############################################################
#.....#..#..#..#.....#........#..#.....#....................#
#..#..#..#..#..#..#..####..####..#..#######..##########..####
#..#..............#..#........#..#........#..#..#.....#.....#
#..####..#######..#..#..#######..#..####..#..#..#..##########
#.....#..#..#.....#.....#..#.....#.....#.................#..#
##########..##########..#..#..#..#..################..####..#
#.....#..#.....#..#...........#.....#.....#..#.....#..#.....#
#..####..####..#..####..####..####..#..#..#..####..#######..#
#..#...........#........#..#..#........#..#.....#........#..#
#..#######..#..##########..#..##########..####..#..#######..#
#...........#...........#..#..#...........#.....#..#.....#..#
#######..####..####..####..#..#######..#..####..#..####..#..#
#.....#..#..#.....#........#..#..#..#..#........#...........#
#..#..#..#..#######..####..#..#..#..####..#..#..#..####..#..#
#..#..#........#........#..#..#..#........#..#.....#..#..#..#
#..####..#..###################..#..#..#..#..####..#..#######
#........#..#........#........#.....#..#..#..#..............#
#..#######..#..#..#..#..#######..#..#..##########..####..#..#
#.....#..#..#..#..#..#........#..#..#..#.....#.....#..#..#..#
####..#..####..####..####..################..####..#..#..#..#
#..#..#.....#..#.................#..#........#..#..#.....#..#
#..#..#..#######..####..##########..#######..#..####..#######
#...........#........#.....#........#........#..............#
#..####..#######..####..#..####..#..####..####..#..#..#######
#.....#........#.....#..#........#..#...........#..#........#
#..####..#..#############..#######..####..#######..#..#..#..#
#.....#..#..#..#.................#........#........#..#..#..#
#######..#..#..####..####..################..##########..#..#
#.....#..#..#........#.....#........#.....#........#..#..#..#
#..#..####..#..####..####..#..##########..##########..#..#..#
#..#........#..#.....#........#.....#....................#..#
####..####..#..#..################..#..####..#######..#..#..#
#........#.....#...........#..#...........#..#.....#..#..#..#
#..####..####..#..#..#..#..#..#..####..#######..#..#..#######
#.....#..#..#..#..#..#..#.....#.....#.....#..#..#.....#.....#
#..#######..#..#######..#..#..#############..#..##########..#
#...........#..#........#..#.....#.....#..............#..#..#
#..##########..##########..#..####..####..#..####..#..#..#..#
#..#....................#..#.....#........#..#.....#........#
#############################################################