#############################################################
#.....#.....#.................#........#..#........#..#.....#
#..####..####..#..#############..####..#..#######..#..#..####
#..#.....#.....#..#..#..#........#...........#........#.....#
#..#..##########..#..#..#######..#######..#..####..#..#..####
#..#...........#........#..............#..#..#..#..#........#
#..####..####..#..#..######################..#..####..#######
#.....#..#........#.....#........#..#...........#.....#.....#
####..####..#######..#######..####..####..#######..#..#..####
#........#..#..#.....#.....#..#.....#..#..#........#..#.....#
#..####..#..#..#..#..#..####..#..####..#..#..#######..#..####
#..#.....#.....#..#..............#.....#.....#........#.....#
#..#######..#..####..#############..#..#..##########..#..####
#........#..#..#...........#..#..#..#..............#..#..#..#
#..#############..#..#..####..#..#######..#..####..####..#..#
#..#.....#..#.....#..#....................#.....#..#........#
#..#..#..#..####..#######..#..####..####..####..#..#..#######
#.....#..#..#........#..#..#..#.....#........#..#.....#.....#
#..####..#..#..#######..##########..####..#..#############..#
#..#..............#.....#........#..#.....#.....#........#..#
#..#############..#..##########..#..####..#############..#..#
#........#.....#..#...........#..#..#....................#..#
####..####..#..#######..####..#..#..####..#######..####..#..#
#..#.....#..#..#........#.....#.....#........#.....#.....#..#
#..##########..####..#..####..#..#..####..#..####..####..#..#
#........#...........#.....#.....#.....#..#..#..#..#........#
#..####..#..####..#############..####..#..#..#..#..##########
#..#...........#..#........#........#..#..#..#........#.....#
#######..##########..####..####..#######..#######..####..####
#..#.....#..#........#........#.....#..#..#..#.....#........#
#..####..#..#..#######..##########..#..#..#..#############..#
#...........#........#.................#..............#.....#
####..#######..#######..#..####..#######..#..#..#..#######..#
#.....#........#.....#..#..#.....#..#.....#..#..#..#........#
#..####..####..#..#######..#..####..####..#..#######..#..#..#
#..#..#.....#..#..#.....#..#.....#........#.....#.....#..#..#
#..#..#######..#..####..####..####..####..####..####..#..####
#.....#..#.................#.....#..#.....#...........#.....#
#..#..#..####..####..#..#..#..#######..#..#..#..####..#######
#..#........#..#.....#..#..#.....#.....#..#..#..#........#..#
#############################################################