#############################################################
#..#...........#..#...........#..#..#.....#.................#
#..#..#######..#..####..#..####..#..#..####..#..##########..#
#..#........#...........#.....#........#.....#........#..#..#
#..################..################..#..#..#..#..#..#..#..#
#.....#.....#........#..#.................#..#..#..#.....#..#
#..#..#..#..####..####..#..#..#######..####..#..####..####..#
#..#.....#..#.....#.....#..#..#..#........#..#.....#.....#..#
#..#..##########..####..#######..#..####..#######..#..#######
#..#........#.....#.................#..#..#..#.....#..#.....#
#..####..####..################..####..####..#..#..#..####..#
#.....#.....#.....#..#...........#..#..#........#..#..#.....#
#######..#..####..#..#######..#..#..#..#..#..#######..#..####
#.....#..#....................#.....#..#..#..#...........#..#
####..#..####..####..#..#############..#############..####..#
#........#.....#..#..#.....#.................#.....#..#.....#
#..#############..#..####..####..#..##########..####..####..#
#..#........#.....#..#.....#.....#..#........#..#........#..#
#######..#..####..#######..#..##########..####..#######..#..#
#..#..#..#....................#...........#..#........#.....#
#..#..#..#############..#..####..####..####..#..##########..#
#........#.....#........#.....#..#........#..#..#.....#.....#
#############..####..####..#######..#######..#..####..#..#..#
#..#.....#.....#.....#..#.....#..#........#...........#..#..#
#..#..####..####..#..#..#######..#######..#######..#..#..#..#
#.....#..#.....#..#.......................#..#.....#.....#..#
####..#..####..#######..#..####..#..#######..#######..####..#
#.....#...........#..#..#..#..#..#.....#.....#........#.....#
#..####..####..#..#..#..#..#..##########..####..#######..#..#
#........#..#..#........#..#...........#..............#..#..#
#..#######..#..#######..#..#..#..#..##########..##########..#
#..#...........#.....#..#.....#..#..#..............#........#
####..##########..####..#######..##########..#..####..####..#
#....................#..#..#.....#.....#.....#.....#.....#..#
#..######################..#..#..#..#..##########..#######..#
#........#...........#..#.....#.....#..#........#..#..#..#..#
#..####..#######..#..#..#..#######..####..##########..#..#..#
#..#.....#.....#..#.....#.....#.....#........#..#...........#
#..####..#..####..#..#..####..####..#..#..#..#..#..####..####
#..#...........#..#..#........#........#..#..#........#.....#
#############################################################