#############################################################
#.....#..#..#.................#..............#........#.....#
#..####..#..#..####..#..#######..#..#..####..#..##########..#
#.....#.....#..#.....#..#..#..#..#..#.....#..#..............#
#..####..##########..####..#..####..#..##########..##########
#.....#...........#.....#.....#.....#.....#........#..#.....#
####..#######..#######..#..#######..#..####..#..#..#..####..#
#..#..#........#.....#...........#..#........#..#........#..#
#..#..#..#######..####..#..#..####..####..#..####..#..####..#
#..#........#........#..#..#..#..#..#.....#..#..#..#..#.....#
#..#..####..#..####..#..#######..#..#######..#..##########..#
#..#.....#........#........#..............#...........#.....#
#..#######..#..#..#..#..#..#..#######..##########..####..####
#.....#..#..#..#..#..#..#..#..#..#.....#.................#..#
####..#..#..#..##########..#..#..###################..#..#..#
#........#..#...........#..#.....#..#.................#.....#
#..####..#..##########..#######..#..####..#..#######..#..####
#.....#.....#...........#..#.....#.....#..#........#..#..#..#
#######..####..####..####..##########..#..#..####..#..#..#..#
#.....#.....#..#..#..#.....#..#..#..#.....#..#.....#..#.....#
#..#..#..#######..#..#..####..#..#..##########..#############
#..#...........#..............#........#...........#........#
#..#######..#..##########..#..#..####..#######..####..#..####
#..#.....#..#..#..#........#.....#..#.....#..#........#.....#
#..#..##########..#..#..#######..#..#..####..#..####..#..####
#..#.................#..#........#..#...........#..#..#.....#
#..####..####..####..#..####..#..#..#..####..#..#..####..####
#..#.....#........#..#.....#..#..#.....#.....#..#.....#.....#
#..####..####..#######..#######..#..################..#..####
#..#........#..#..#..#........#..#..............#.....#..#..#
#..#############..#..##########..##########..####..#..####..#
#........#..............#........#.....#..#..#..#..#..#.....#
#..##########..#######..####..#..#..####..####..#..####..####
#..#........#..#.....#..#..#..#..#........#........#........#
#..####..#######..#..#..#..##########..####..####..#..####..#
#.................#.....#.................#.....#..#..#.....#
#..####..#..##########..#######..####..####..####..#..#######
#.....#..#........#..#........#.....#..#..#.....#.....#.....#
#..####..##########..#..#..#..#..#######..####..#######..#..#
#.....#...........#.....#..#.............................#..#
#############################################################