#############################################################
#.....#........#..#.................#..#.....#..#..#.....#..#
#..####..####..#..#..#######..####..#..#..#..#..#..#..#..#..#
#.....#.....#...........#........#..#.....#...........#.....#
#..####..#######..#############..#..#..#..#..#######..####..#
#...........#...........#........#.....#..#.....#..#..#.....#
#..####..#######..#..#..#..#############..####..#..#..#..####
#..#...........#..#..#..#..............#..#........#..#.....#
##########..####..####..#############..#..#..####..####..####
#........#.....#.....#..#.....#........#..#..#.....#..#..#..#
####..#######..#######..#..#..#..#..#############..#..####..#
#..#.....#........#........#..#..#...........#..#.....#.....#
#..#..##########..#######..#..####..#######..#..#######..####
#..#.....#..............#..#.....#..#..#..#.....#........#..#
#..#..#######..#######..#############..#..#..#..#######..#..#
#..#...........#.....#..#..#.....#...........#..#........#..#
#..#..#############..#..#..#..#..#######..####..#..####..#..#
#........#..#..#.....#........#..#..#..#.....#..#..#..#.....#
####..####..#..#..#######..#######..#..##########..#..####..#
#.................#.....#..............#..#.....#.....#.....#
#..####..#######..#..####..#..#..#######..#..#..#..####..####
#.....#........#........#..#..#........#.....#..#..#........#
#..##########..##########..##########..#..#######..##########
#..#...........#.....#........#.................#.....#..#..#
#..##########..#..#..#######..####..####..#..#..#..#..#..#..#
#...........#..#..#..#..#........#.....#..#..#..#..#.....#..#
####..#..#..#..#..#..#..##########..#..#######..#######..#..#
#.....#..#..#..#..#..#..#..#........#.....#...........#.....#
####..####..#######..#..#..####..#######..####..####..#..####
#.....#.....#..............#........#..#.....#.....#..#.....#
#..#######..####..#..####..#..#######..#######..#######..#..#
#........#..#.....#.....#..#..#..#..#.....#..#.....#..#..#..#
#..#..#..#..##########..#######..#..#..####..#..####..#..####
#..#..#..#.....#........#..#..............#........#........#
#######..####..#..#######..####..####..##########..#..####..#
#.....#..#..#........#.....#........#.....#.....#........#..#
#..#######..####..#######..#..#..####..####..#..#..####..####
#..#.................#.....#..#.....#.....#..#..#.....#.....#
#..#..####..####..#######..#..####..####..####..#..#..#..####
#........#.....#.................#..#.....#........#..#.....#
#############################################################