#############################################################
#..............#.....#...........#.....#........#...........#
####..#######..#..#..#..#..#######..####..#..#..#..#..#######
#........#........#..#..#..#.....#........#..#.....#........#
#..#######..#..####..#..#######..####..####..#..#######..####
#.....#.....#.....#.....#..#...........#.....#........#.....#
#######..#######..#######..#######..#..#######..#..##########
#........#..#.....#...........#.....#..#..#.....#..#.....#..#
####..####..####..#..####..####..#######..#..#..####..####..#
#.....#..#.....#.....#.....#..#.....#........#..#..#.....#..#
####..#..#..####..#..####..#..#..#..#..####..####..####..#..#
#........#.....#..#..#..#........#..#.....#.................#
####..#######..####..#..#..#..#..#..#..####..#..#..#######..#
#.....#..#...........#.....#..#..#..#..#.....#..#.....#.....#
#..#..#..#..####..##########..####..#######..#..#######..#..#
#..#..#........#.....#..#..#.....#........#..#........#..#..#
#############..#######..#..#..#############..####..##########
#...........#........#.....#...........#..#.....#........#..#
####..#######..#######..##########..####..##########..####..#
#........#........#..#..#..............#..#.....#..#........#
#..####..####..####..#..####..#..#######..####..#..#..####..#
#.....#...........#.....#..#..#........#..#..#..#........#..#
#..#######..#######..#..#..##########..#..#..#..####..#######
#.....#........#.....#.....#........#..#.....#..............#
#..#..####..#..#..#..####..#..#############..#######..#..#..#
#..#..#.....#.....#..#..............#........#.....#..#..#..#
#######..#######..####..#############..#..####..#..#######..#
#........#..#.....#.....#.....#........#.....#..#..#..#.....#
#..####..#..####..#..#..#..####..#..####..#..#..####..#..#..#
#..#..#..#........#..#..#..#..#..#.....#..#..#..#..#..#..#..#
#..#..#..####..#..#######..#..#..####..#######..#..#..#######
#.....#..#.....#..............#..#.....#.....#.....#..#.....#
################..####..##########..####..#..####..#..####..#
#.....#........#..#.....#..#..#.....#.....#..#........#.....#
#..#######..#..####..#..#..#..#..#..#######..####..#..#..####
#..#..#.....#.....#..#..#.....#..#.................#.....#..#
#..#..####..##########..#..##########..#..##########..####..#
#........#.....#.....#..#.....#........#.....#........#.....#
#..####..#..####..#..#..#..#######..#######..#######..#..#..#
#.....#...........#.................#..............#.....#..#
#############################################################