#############################################################
#..#.....#..#.................#.....#..#..#.....#...........#
#..####..#..####..####..#..#..####..#..#..#..####..####..#..#
#.....#..#..#.....#.....#..#..#...........#..#........#..#..#
#..#..#..#..####..#..####..#..####..#######..####..####..####
#..#.....#..#.....#..#..#..#.....#...........#..#..#........#
#..####..#..#######..#..#..####..#..####..####..#..##########
#..#...........#..#..#........#..#..#...........#...........#
#############..#..####..#######..#######..####..#..#######..#
#..#.................#.....#........#........#........#.....#
#..#..#..#######..#..##########..#..#############..##########
#.....#.....#.....#.....#........#...........#.....#........#
#..#############..####..#..##########..#######..####..#..#..#
#.....#.....#.....#..#..#........#.....#...........#..#..#..#
#######..#..#..#..#..#..#######..#######..##########..#..####
#........#.....#..#........#...........#...........#..#..#..#
#..####..#######..#######..####..####..#..####..####..####..#
#..#..#..#.....#........#........#.....#..#.....#........#..#
####..#..#..#..#..##########..#######..#..####..#..####..#..#
#........#..#..#...........#........#..#..#..#.....#..#..#..#
#..#..#..####..#..#..####..####..#..#..#..#..#..#..#..####..#
#..#..#.....#.....#.....#..#..#..#..#.....#.....#..#..#.....#
#..#######..#######..#######..#..####..####..####..#..####..#
#.....#.....#.....#..#.....#........#.....#.....#..#........#
#..####..####..#..#######..####..##########..##########..#..#
#.....#..#.....#.....#..............#..............#..#..#..#
####..####..####..##########..#..#..#############..#..####..#
#.....#..#.....#.....#..#.....#..#.....#.....#..............#
#######..#..####..#..#..#######..#######..####..#############
#........#..#.....#.....#....................#........#.....#
#..#..####..#..####..####..####..################..#######..#
#..#........#..#........#.....#........#..#.....#.....#.....#
#..##########..####..#..#..####..#######..####..####..####..#
#..#..#........#.....#.....#..#..#.....#........#..#........#
####..#######..####..#..####..#..####..#..#######..#..####..#
#..#..#........#..#..#.....#.....#..#..#..#...........#.....#
#..#..#######..#..################..#..#..#############..####
#..#.................#....................#.....#...........#
#..####..#############..####..#..####..#..#..#..#..####..#..#
#.................#.....#.....#.....#..#.....#........#..#..#
#############################################################